8 21
#########&&##########
########&--&#########
#&&&&&&&&--&&&&&&&&&#
&------------------&#
#&&&&&&&&--&&&&&&&&&#
########&--&#########
########&--&#########
#########0&##########